{
  "tilemap":[
    [1,1,1,1,1,1,8,8,8,1,1,1,1,1,1],
    [1,0,0,0,0,0,0,0,0,0,0,0,0,0,1],
    [1,0,0,0,0,0,0,0,0,0,0,0,0,0,1],
    [1,0,2,0,0,0,0,0,0,0,0,0,2,0,1],
    [1,0,2,0,2,2,2,2,2,2,2,0,2,0,1],
    [1,0,2,0,0,0,0,0,0,0,0,0,2,0,1],
    [8,0,2,0,2,0,2,2,2,0,2,0,2,0,8],
    [8,0,2,0,2,0,2,4,2,0,2,0,2,0,8],
    [8,0,2,0,2,0,2,0,2,0,2,0,2,0,8],
    [1,0,2,0,0,0,0,0,0,0,0,0,2,0,1],
    [1,0,2,0,2,2,2,2,2,2,2,0,2,0,1],
    [1,0,2,0,0,0,0,0,0,0,0,0,2,0,1],
    [1,0,0,0,0,0,0,0,0,0,0,0,0,0,1],
    [1,0,0,0,0,0,0,0,0,0,0,0,0,0,1],
    [1,1,1,1,1,1,8,8,8,1,1,1,1,1,1]
  ],
  "entitymap":[
    [0,0,0,0,0,0,0,0,0,0,0,0,0,0,0],
    [0,0,0,0,0,0,0,0,0,0,0,0,0,0,0],
    [0,0,0,0,0,0,0,0,0,0,0,0,0,0,0],
    [0,0,0,0,0,0,0,0,0,0,0,0,0,0,0],
    [0,0,0,0,0,0,0,0,0,0,0,0,0,0,0],
    [0,0,0,0,0,0,0,0,0,0,0,0,0,0,0],
    [0,0,0,0,0,0,0,0,0,0,0,0,0,0,0],
    [0,0,0,0,0,1,0,0,0,1,0,0,0,0,0],
    [0,0,0,0,0,0,0,2,0,0,0,0,0,0,0],
    [0,0,0,0,0,0,0,0,0,0,0,0,0,0,0],
    [0,0,0,0,0,0,0,0,0,0,0,0,0,0,0],
    [0,0,0,0,0,0,0,0,0,0,0,0,0,0,0],
    [0,0,0,0,0,0,0,0,0,0,0,0,0,0,0],
    [0,0,0,0,0,0,0,0,0,0,0,0,0,0,0],
    [0,0,0,0,0,0,0,0,0,0,0,0,0,0,0]
  ],
  "rotates":true
}